a	-
abandon	palikti
ability	gebëjimas
able	gali
abortion	abortas
about	apie
above	virð
abroad	uþsienyje
absence	nebuvimas
absolute	absoliutus
absolutely	visiðkai
absorb	sugerti
abstract	abstraktus
abuse	piktnaudþiavimas
academic	akademinis
accelerate	paspartinti
accent	akcentas
accept	priimti
acceptable	priimtinas
acceptance	priëmimas
access	prieiga
accessible	prieinamas
accident	avarija
accommodate	prisitaikyti
accompany	lydëti
accomplish	pasiekti
accomplishment	pasiekimas
according	pagal
account	sàskaita
accountability	atskaitomybë
accounting	apskaita
accuracy	tikslumas
accurate	tiksli
accurately	tiksliai
accusation	kaltinimas
accuse	kaltinti
achieve	pasiekti
achievement	pasiekimas
acid	rûgðtis
acknowledge	pripaþinti
acquire	ásigyti
acquisition	ásigijimas
across	visoje
act	veikti
action	veiksmas
active	aktyvus
actively	aktyviai
activist	aktyvistas
activity	veikla
actor	aktorius
actress	aktorë
actual	tikras
actually	ið tikrøjø
adapt	prisitaikyti
add	papildyti
added	pridëta
addition	papildymas
additional	papildomas
address	adresas
adequate	tinkamas
adjust	reguliuoti
adjustment	koregavimas
administer	administruoti
administration	administracija
administrative	administracinës
administrator	administratorius
admire	þavëtis
admission	priëmimas
admit	pripaþinti
adolescent	paauglys
adopt	priimti
adoption	priëmimas
adult	suaugusiøjø
advance	ið anksto
advanced	paþengæs
advantage	pranaðumas
adventure	nuotykiai
advertising	reklama
advice	patarimas
advise	patarti
adviser	patarëjas
advocate	advokatas
aesthetic	estetinis
affair	reikalas
affect	paveikti
afford	pajëgti
afraid	iðsigandæs
African	Afrikos
African-American	Afroamerikietis
after	po to
afternoon	po pietø
afterward	vëliau
again	darkart
against	prieð
age	amþius
agency	agentûra
agenda	darbotvarkë
agent	agentas
aggression	agresija
aggressive	agresyvus
ago	prieð
agree	sutikti
agreement	susitarimas
agricultural	þemës ûkio
agriculture	Þemdirbystë
ahead	priekyje
aid	pagalba
aide	aide
AIDS	AIDS
aim	tikslas
air	oro
aircraft	orlaivis
airline	oro linijø bendrovë
airplane	lëktuvas
airport	oro uostà
aisle	perëjimas
alarm	signalas
album	albumas
alcohol	alkoholis
alien	svetimas
alike	panaðûs
alive	gyvas
all	visi
allegation	átarimas
alleged	tariamas
allegedly	tariamai
alley	alëja
alliance	aljansas
ally	sàjungininkas
allow	leisti
almost	beveik
alone	vien tik
along	kartu
alongside	ðalia
already	jau
also	taip pat
alter	pakeisti
alternative	alternatyva
although	nors
altogether	visiðkai
aluminum	aliuminis
always	visada
amazing	nuostabi
ambassador	ambasadorius
ambition	ambicija
ambitious	ambicingas
amendment	pakeitimà
American	Amerikos
amid	tarp
among	tarp
amount	suma
analysis	analizë
analyst	analitikas
analyze	analizuoti
ancestor	protëviai
ancient	senovës
and	ir
angel	angelas
anger	pyktis
angle	kampas
angry	piktas
animal	gyvûnas
any	bet kuris
anybody	bet kas
anymore	nebëra
anyone	kas nors
anything	kà nors
anyway	vistiek
anywhere	bet kur
ankle	kulkðnis
anniversary	metinës
announce	paskelbti
annual	kasmet
annually	kasmet
anonymous	anoniminis
another	kità
answer	atsakymas
anticipate	numatyti
anxiety	nerimas
anxious	neramus
apart	atskirai
apartment	butas
apologize	atsipraðyti
apology	atsipraðymas
apparent	akivaizdus
apparently	matyt
appeal	kreiptis
appear	pasirodys
appearance	iðvaizda
apple	obuolys
application	taikymo
apply	taikyti
appoint	paskirti
appointment	paskyrimas
appreciate	vertinti
appreciation	dëkingingumas
approach	metodas
appropriate	tinkama
approval	patvirtinimas
approve	patvirtinti
approximately	maþdaug
architect	architektas
architecture	architektûra
area	sritis
arena	arena
argue	teigti
argument	argumentas
arise	kilti
arm	ranka
armed	ginkluotas
army	armija
around	aplink
array	masyvas
arrange	suorganizuoti
arrangement	iðdëstymas
arrest	areðtuoti
arrival	atvykimas
arrive	atvykti
arrow	rodyklë
art	menas
article	straipsnis
articulate	suformuluoti
artifact	artefaktas
artificial	dirbtinis
artist	menininkas
artistic	meninis
as	kaip
ash	pelenai
Asian	Azijos
aside	nuoðalyje
ask	paklausti
asleep	miegoti
aspect	aspektas
assault	uþpuolimas
assemble	surinkti
assembly	surinkimas
assert	tvirtinti
assess	ávertinti
assessment	vertinimà
asset	turtas
assign	priskirti
assignment	priskyrimas
assist	padëti
assistance	pagalba
assistant	asistentas
assistant	asistentas
associate	bendradarbis
associated	susijæ
association	asociacija
assume	prisiimti
assumption	prielaida
assure	uþtikrinti
astronomer	astronomas
at	-
athlete	sportininkas
athletic	atletiðkas
atmosphere	atmosfera
attach	pridëti
attack	ataka
attempt	bandymas
attend	dalyvauti
attendance	dalyvavimas
attention	dëmesys
attitude	poþiûris
attorney	advokatas
attract	pritraukti
attraction	patrauklumas
attractive	patrauklus
attribute	atributas
auction	aukcione
audience	auditorija
aunt	teta
author	autorius
authority	institucija
authorize	leisti
auto	automatinis
automatic	automatinis
automatically	automatiðkai
automobile	automobiliø
autonomy	autonomija
availability	prieinamumà
available	galima
average	vidurkis
avoid	vengti
await	laukti
away	toli
awake	pabudæs
award	apdovanojimas
aware	þinoti
awareness	sàmoningumas
awful	baisus
baby	kûdikis
back	atgal
background	fonas
backyard	galinis kiemas
bacteria	bakterijø
bad	blogai
badly	blogai
bag	maiðas
bay	álanka
bake	kepti
balance	balansas
balanced	subalansuota
ball	kamuolys
balloon	balionas
ballot	balsavimas
ban	uþdrausti
banana	bananas
band	juosta
bank	bankas
banker	bankininkas
banking	bankininkystë
bankruptcy	bankrotas
bar	baras
bare	plikas
barely	vos
barn	tvartas
barrel	barelis
barrier	barjeras
base	bazë
baseball	beisbolas
basement	rûsys
basic	paprastas
basically	ið esmës
basis	pagrindu
basket	krepðelis
basketball	krepðinis
bat	ðikðnosparnis
bath	vonia
bathroom	vonia
battery	baterija
battle	mûðis
be	bûti
beach	papludimys
beam	sijos
bean	pupelës
bear	turëti
beard	barzda
beast	þvëris
beat	muðti
beat	muðti
beautiful	graþus
beauty	groþis
because	nes
become	tapti
bed	lova
bedroom	miegamasis
bee	bitë
beef	jautiena
beer	alus
before	prieð
beg	elgetauti
begin	pradëti
beginning	pradþia
behalf	vardu
behave	elgtis
behavior	elgesys
behavioral	elgesio
behind	atsilikti
being	esamas
beyond	uþ
belief	tikëjimas
believe	tikëki
bell	varpas
belly	pilvas
belong	priklausyti
below	þemiau
belt	dirþas
bend	sulenkti
beneath	þemiau
benefit	nauda
beside	ðalia
besides	be to
best	geriausias
bet	laþybos
better	geriau
between	tarp
bias	ðaliðkumas
Bible	Biblija
bicycle	dviratis
bid	pasiûlymas
big	didelis
bike	dviratis
bill	sàskaita
billion	milijardas
bind	ápareigoti
biography	biografija
biological	biologinis
biology	biologija
bird	paukðtis
birth	Gimdymas
birthday	gimtadienis
bishop	vyskupas
bite	ákansti
bitter	kartus
by	iki
black	juoda
blade	aðmenys
blame	kaltas
blank	tuðèias
blanket	antklodë
blast	sprogimas
blend	maiðyti
bless	palaiminti
blessing	palaiminimas
blind	aklas
blink	mirksëti
block	blokuoti
blond	ðviesus
blood	kraujas
bloody	kruvinas
blow	pûsti
blue	mëlyna
board	lenta
boast	pasigirti
boat	valtis
body	kûnas
boil	virti
boy	berniukas
boyfriend	vaikinas
bold	paryðkinti
bolt	varþtas
bomb	bomba
bombing	bombardavimas
bond	obligacijos
bone	kaulas
bonus	premija
book	knyga
boost	padidinti
booth	kabina
border	siena
boring	nuobodus
born	gimæs
borrow	skolintis
boss	bosas
both	abu
bother	nerimauti
bottle	butelis
bottom	apaèioje
boundary	riba
bow	lankas
bowl	dubuo
box	dëþë
brain	smegenys
brake	stabdis
branch	filialas
brand	prekës þenklas
brave	dràsus
bread	duona
break	pertrauka
breakfast	pusryèiai
breast	krûtis
breath	kvëpavimas
breathe	kvëpuoti
breathing	kvëpavimas
breeze	vëjas
brick	plyta
bride	nuotaka
bridge	tiltas
brief	trumpas
briefly	trumpai
bright	ðviesus
brilliant	puikus
bring	atsineðti
British	Britai
broad	platus
broadcast	transliuoti
broken	neveikiantis
broker	tarpininkas
bronze	bronza
brother	brolis
brown	ruda
brush	ðepetys
brutal	þiauriai
bubble	burbulas
bucket	kibiras
buddy	draugas
budget	biudþeto
bug	klaida
build	pastatyti
builder	statybininkas
building	pastatas
buy	pirkti
buyer	pirkëjas
bulb	lemputë
bull	bulius
bullet	kulka
bunch	krûva
burden	naðta
bureau	biuras
bury	palaidoti
burn	deginti
burning	deginimas
burst	sprogti
bus	autobusas
bush	krûmas
business	verslas
businessman	verslininkas
busy	uþsiëmæs
but	bet
butt	uþpakalis
butter	sviestas
butterfly	drugelis
button	mygtukas
cab	Taksi
cabin	kabina
cabinet	spintelë
cable	kabelis
cage	narve
cake	tortas
calculate	apskaièiuoti
calculation	apskaièiavimas
calendar	kalendorius
call	skambinti
calm	ramus
camera	kamera
camp	stovykla
campaign	kampanija
campus	miestelis
can	galëti
cancel	atðaukti
cancer	vëþys
candidate	kandidatas
candy	saldainiai
candle	þvakë
canvas	drobë
cap	dangtelis
capability	gebëjimas
capable	gali
capacity	pajëgumus
capital	kapitalas
captain	kapitonas
capture	sugauti
car	automobilis
carbohydrate	angliavandeniai
carbon	anglis
card	kortelë
care	priþiûrëti
career	karjera
careful	atsargus
carefully	atidþiai
carpet	kilimas
carrier	veþëjas
carry	neðioti
carrot	morka
cart	krepðelis
cartoon	animacinis filmas
carve	iðkirpti
case	atveju
case	atveju
cash	grynieji pinigai
casino	kazino
cast	mesti
casual	kasdienis
cat	katë
catalog	katalogas
catch	sugauti
category	Kategorija
Catholic	Katalikas
cattle	galvijai
cause	prieþastis
cave	urvas
cease	nutraukti
ceiling	lubos
celebrate	ðvesti
celebration	ðventë
celebrity	garsenybë
cell	làstelë
cemetery	kapinës
center	centras
central	centrinis
century	amþiaus
CEO	Vadovas
ceremony	ceremonija
certain	tam tikras
certainly	tikrai
chain	grandinë
chair	këdë
chairman	pirmininkas
challenge	iððûkis
chamber	kamera
champion	èempionas
championship	èempionatas
chance	tikimybë
change	pakeisti
changing	keièiasi
channel	kanalas
chaos	chaosas
chapter	skyriuje
character	charakteris
characteristic	charakteristika
characterize	apibûdinti
charge	mokestis
charity	labdara
charm	þavesys
chart	diagrama
chase	Vytis
cheap	pigûs
cheat	apgauti
check	patikrinti
cheek	skruostas
cheer	nudþiuginti
cheese	sûris
chef	virëjas
chemical	cheminës medþiagos
chemistry	chemija
chest	krûtinë
chew	kramtyti
chicken	viðtiena
chief	virðininkas
child	vaikas
childhood	vaikystëje
chin	smakras
Chinese	Kinø
chip	lustas
chocolate	ðokoladas
choice	pasirinkimas
cholesterol	cholesterolio
choose	pasirinkti
chop	pjaustyti
Christian	Krikðèionis
Christianity	Krikðèionybë
Christmas	Kalëdos
chronic	lëtinis
chunk	gabalas
church	baþnyèia
cigarette	cigaretë
circle	ratas
circuit	grandinë
circumstance	aplinkybës
cite	paminëti
citizen	pilietis
citizenship	pilietybë
city	miestas
civic	pilietinis
civil	pilietinës
civilian	civilinis
civilian	civilinis
civilization	civilizacija
cycle	ciklas
claim	reikalauti
clay	molis
class	klasë
classic	klasikinis
classical	klasikinis
classify	klasifikuoti
classroom	klasë
clean	ðvarus
clear	aiðku
clearly	aiðkiai
clerk	sekretorius
click	paspausti
client	klientas
cliff	uolos
climate	klimatas
climb	lipti
cling	laikosi
clinic	klinika
clinical	klinikiniai
clip	klipas
clock	laikrodis
close	Uþdaryti
closed	uþdaryta
closely	atidþiai
closer	arèiau
closest	arèiausiai
closet	spinta
cloth	audinys
clothes	drabuþiai
clothing	apranga
cloud	debesis
club	klubas
clue	raktas
cluster	klasteris
coach	treneris
coal	anglis
coalition	koalicija
coast	pakrantë
coastal	pakrantës
coat	kailis
cocaine	kokainas
code	kodas
coffee	kava
cognitive	paþinimo
coin	moneta
cold	ðalta
collaboration	bendradarbiavimà
collapse	suþlugti
collar	apykaklë
colleague	kolega
collect	rinktis
collection	rinkimas
collective	kolektyvinis
collector	surinkëjas
college	kolegija
colonial	kolonijinis
colony	kolonija
color	spalva
colorful	spalvingas
column	stulpelis
columnist	kolonistas
combat	kovoti
combination	derinys
combine	derinti
combined	kartu
come	ateiti
comedy	komedija
comfort	komfortas
comfortable	patogus
coming	ateinantis
command	komanda
commander	vadas
comment	komentaras
commercial	komercinës
commission	Komisija
commissioner	Komisijos narys
commit	ásipareigoti
commitment	ásipareigojimas
committee	komitetui
commodity	prekë
common	bendras
commonly	paprastai
communicate	bendrauti
communication	komunikacijos
community	bendruomenei
companion	draugas
company	ámonë
comparable	palyginamas
compare	palyginti
comparison	palyginimas
compel	priversti
compelling	átikinamas
compensation	kompensacija
compete	konkuruoti
competition	varþybos
competitive	konkurencinga
competitor	konkurentas
complain	skundþiasi
complaint	skundas
complete	uþbaigti
completely	visiðkai
complex	kompleksas
complexity	sudëtingumas
compliance	laikymasis
complicated	sudëtinga
comply	laikytis
component	komponentas
compose	raðyti
composition	sudëtis
compound	junginys
comprehensive	iðsaus
comprise	apimti
compromise	kompromisas
computer	kompiuteris
concede	pripaþinti
conceive	suvokti
concentrate	koncentratas
concentration	koncentracija
concept	koncepcija
conception	koncepcija
concern	susirûpinimas
concerned	susirûpinæs
concerning	dël
concert	koncertas
conclude	baigti
conclusion	iðvada
concrete	betonas
condemn	pasmerkti
condition	sàlyga
conduct	elgesys
conference	konferencija
confess	prisipaþinti
confession	iðpaþinimas
confidence	pasitikëjimas
confident	ásitikinæs
confirm	patvirtinti
conflict	konfliktas
confront	susidurti
confrontation	konfrontacija
confuse	supainioti
confusion	painiava
Congress	Kongresas
connect	Prisijungti
connection	ryðys
conscience	sàþinë
conscious	sàmoningas
consciousness	sàmonë
consent	sutikimas
consequence	pasekmë
consequently	atitinkamai
conservation	iðsaugojimas
conservative	konservatyvus
consider	apsvarstyti
considerable	didelis
considerably	þymiai
consideration	svarstymas
consist	sudaryti
consistent	nuosekliai
consistently	nuosekliai
conspiracy	sàmokslo
constant	pastovus
constantly	nuolat
constitute	sudaryti
constitution	konstitucija
constitutional	konstitucinis
constraint	apribojimas
construct	statyti
construction	statybos
consult	konsultuotis
consultant	konsultantas
consume	vartoti
consumer	vartotojas
consumption	vartojimas
contact	kontaktas
contain	yra
container	konteineris
contemplate	apsvarstyti
contemporary	ðiuolaikiðkas
contend	teigti
content	turinys
contest	konkursas
context	kontekste
continent	þemynas
continue	tæsti
continued	tæsiamas
continuing	toliau
continuous	nuolat
contract	sutartis
contractor	rangovas
contrast	kontrastas
contribute	prisidëti
contribution	ánaðas
contributor	pagalbininkas
control valdyti
controversial	prieðtaringas
controversy	nesutarimai
convey	perduoti
convenience	patogumas
convention	konvencija
conventional	sutartinis
conversation	pokalbá
conversion	konversija
convert	paversti
convict	nuteisti
conviction	ásitikinimas
convince	átikinti
convinced	ásitikinæs
cook	virëjas
cookie	slapukas
cooking	gaminimas
cool	ðaunus
cooperate	bendradarbiauti
cooperation	bendradarbiavimas
cooperative	kooperatyvas
coordinate	koordinuoti
coordinator	koordinatorius
cop	policininkas
cope	susidoroti
copy	kopija
cord	laidas
core	branduolys
corn	kukurûzai
corner	kampas
corporate	bendras
corporation	korporacija
correct	teisingas
correctly	teisingai
correlation	koreliacija
correspondent	korespondentas
corridor	koridorius
corruption	korupcija
cost	kaina
costly	brangus
costume	kostiumas
cottage	kotedþas
cotton	medvilnës
couch	sofa
could	-
council	taryba
counsel	patarëjas
counseling	konsultavimas
counselor	patarëjas
count	skaièiuoti
counter	skaitiklis
counterpart	kolega
county	apskritis
country	Ðalis
coup	perversmas
couple	pora
courage	dràsos
course	Þinoma
court	teismas
courtroom	teismo salë
cousin	pusbrolis
cover	padengti
cow	karvë
craft	amatas
crash	gedimas
crawl	nuskaityti
crazy	iðprotëjæs
cream	grietinëlë
create	sukurti
creation	kûrimas
creative	kûrybingas
creativity	kûrybiðkumas
creature	padaras
credibility	patikimumas
credit	kreditas
crew	águla
crime	nusikalstamumas
criminal	nusikaltëlis
crisis	krizë
criteria	kriterijai
critic	kritikas
critical	kritiðkai
criticism	kritika
criticize	kritikuoti
cry	verkti
crystal	kriðtolas
crop	pasëliai
cross	kirsti
crowd	minia
crowded	perkrautas
crucial	labai svarbu
cruel	þiaurus
cruise	kruizas
crush	sutraiðkyti
cultural	kultûros
culture	kultûrà
cup	puodelis
cure	iðgydyti
curiosity	smalsumas
curious	smalsu
currency	valiuta
current	srovë
currently	ðiuo metu
curriculum	mokymo planas
curtain	uþuolaida
curve	kreivë
custody	globa
custom	paprotys
customer	klientas
cut	supjaustyti
cute	mielas
dad	tëtis
daily	kasdien
day	diena
dam	uþtvanka
damage	þala
damn	prakeiktas
dance	ðokis
dancer	ðokëja
dancing	ðokiai
danger	pavojus
dangerous	pavojinga
dare	iðdrásti
dark	tamsus
darkness	tamsoje
data	duomenis
database	duomenø bazë
date	data
daughter	dukra
dawn	auðra
dead	miræs
deadline	terminas
deadly	mirtinas
deal	spræsti
dealer	prekiautojas
dear	brangus
death	mirtis
debate	diskusijos
debris	ðiukðles
debt	skolos
debut	debiutas
decade	deðimtmetis
decent	padorus
decide	nuspræsti
decision	sprendimas
deck	denis
declare	paskelbti
decline	maþëti
decorate	dekoruoti
decrease	maþinti
dedicate	skirti
deem	manoma
deep	giliai
deeply	giliai
deer	elnias
defeat	nugalëti
defend	ginti
defendant	atsakovas
defender	gynëjas
defense	gynyba
defensive	gynybinis
deficit	trûkumas
define	apibrëþti
definitely	tikrai
definition	apibrëþimas
degree	laipsnis
delay	delsimas
deliberately	tyèia
delicate	subtilus
delight	malonumas
deliver	pristatyti
delivery	pristatymas
demand	paklausa
democracy	demokratija
Democrat	Demokratas
democratic	demokratijos
demographic	Demografija
demonstrate	demonstruoti
demonstration	demonstracija
denial	neigimas
deny	paneigti
dense	tankus
density	tankis
depart	iðvykti
department	departamentas
departure	iðvykimo
depend	priklauso
dependent	priklausomas
depending	priklausomai nuo
depict	pavaizduoti
deploy	diegti
deposit	uþstatas
depression	depresija
depth	gylis
deputy	pavaduotojas
derive	gauti
descend	nusileisti
describe	apibûdinti
description	apibûdinimas
desert	dykuma
deserve	nusipelno
design	dizainas
design	dizainas
designer	dizaineris
desire	noras
desk	stalas
desperate	beviltiðka
desperately	Beviltiðkai
despite	nepaisant
dessert	desertas
destination	Kelionës tikslas
destroy	sunaikinti
destruction	sunaikinimo
detail	iðsamiai
detailed	detalus
detect	aptikti
detective	detektyvas
determination	nustatymas
determine	nustatyti
devastating	praþûtingas
develop	plëtoti
developer	programuotojas
developing	plëtoti
development	vystymàsis
developmental	vystymosi
device	prietaisas
devil	velnias
devote	skirti
diabetes	diabetas
diagnose	diagnozuoti
diagnosis	diagnozë
dialogue	dialogas
diamond	deimantas
diary	dienoraðtis
dictate	diktuoti
die	mirti
diet	mityba
differ	skiriasi
difference	skirtumas
different	skiriasi
differently	kitaip
difficult	sunku
difficulty	sunkumas
dig	kasti
digital	skaitmeninis
dignity	orumà
dilemma	dilema
dimension	dimensija
diminish	maþëja
dining	pietauti
dinner	vakarienë
dip	panardinti
diplomat	diplomatas
diplomatic	diplomatinë
direct	nukreipti
direction	kryptis
directly	tiesiogiai
director	direktorius
dirt	neðvarumai
dirty	purvinas
disability	negalios
disabled	iðjungta
disagree	nesutikti
disappear	iðnyksta
disappointed	nusivylæs
disappointment	nusivylimas
disaster	nelaimë
disc	diskas
discipline	drausmës
disclose	atskleisti
discount	nuolaida
discourage	atgrasyti
discourse	diskursas
discover	atrasti
discovery	atradimas
discrimination	diskriminacija
discuss	aptarti
discussion	diskusija
disease	liga
dish	patiekalas
disk	diskas
dismiss	atleisti
disorder	sutrikimas
display	rodyti
dispute	ginèas
dissolve	iðtirpinkite
distance	atstumas
distant	toli
distinct	atskriti
distinction	atskyrimas
distinctive	skiriamasis
distinguish	iðskirti
distract	atitraukti
distribute	paskirstyti
distribution	paskirstymas
district	rajonas
disturb	sutrikdyti
disturbing	sutrikdantis
diverse	ávairi
diversity	ávairovë
divide	padalinti
divine	dieviðkas
division	padalijimas
divorce	skyrybø
divorce	skyrybø
dying	mirðta
dynamic	dinamiðkas
dynamics	dinamika
DNA	DNR
do	daryti
dock	prieplauka
doctor	gydytojas
doctrine	doktrina
document	dokumentas
documentary	dokumentinis
dog	ðuo
doll	lëlë
domain	domenas
domestic	vidaus
dominant	dominuojantis
dominate	dominuojti
donate	paaukoti
donation	donorystë
donor	donoras
door	durys
dose	dozë
dot	taðkas
double	dvigubai
doubt	abejonës
dough	teðla
down	þemyn
downtown	miesto centre
dozen	deðimtys
draft	projektas
drag	vilkti
drain	nutekëjimas
drama	drama
dramatic	dramatiðkas
dramatically	dramatiðkai
draw	pieðti
drawer	stalèius
drawing	pieðimas
dream	svajonë
dream	svajonë
dress	suknelë
dress	suknelë
dried	dþiovinti
drift	dreifas
drill	gràþtas
drink	gerti
drinking	gërimas
drive	vairuoti
driver	vairuotojas
driveway	vaþiuojamosios dalies
driving	vairavimas
dry	sausas
drop	laðas
drown	nuskæsti
drug	narkotikai
drum	bûgnas
drunk	girtas
duck	antis
due	iki
dumb	kvailas
dump	sàvartynas
during	per
dust	dulkës
duty	pareia
each	kiekvienas
eager	norëti
ear	ausis
early	anksti
earn	uþdirbti
earnings	uþdarbis
earth	þemë
earthquake	þemës drebëjimas
ease	lengvumas
ease	lengvumas
easily	lengvai
easy	lengva
east	rytai
eastern	rytø
eat	valgyti
eating	valgymas
echo	aidas
ecological	ekologiðkas
economic	ekonominis
economically	ekonomiðkai
economics	ekonomika
economist	ekonomistas
economy	ekonomika
ecosystem	ekosistema
edge	kraðtas
edit	Redaguoti
edition	leidimas
editor	redaktorius
educate	ðviesti
education	ðvietimas
educational	ðvietimo
educator	pedagogas
effect	poveikis
effective	veiksmingas
effectively	veiksmingai
effectiveness	efektyvumas
efficiency	efektyvumà
efficient	efektyvus
effort	pastangos
egg	kiauðinis
ego	ego
eight	aðtuoni
eighth	aðtuntoji
either	taip pat
eye	akis
eyebrow	antakis
elaborate	detalizuoti
elbow	alkûnë
elder	vyresnysis
elderly	vyresnio amþiaus
elect	iðrinkti
election	rinkimai
electric	elektrinis
electrical	elektros
electricity	elektros energijos
electronic	elektroniniu bûdu
electronics	elektronika
elegant	elegantiðkas
element	elementas
elementary	elementarios
elephant	dramblys
elevator	liftas
eleven	vienuolika
eligible	reikalavimus
eliminate	paðalinti
elite	elitas
else	Kitas
elsewhere	kitur
embarrassed	sutrikæs
embrace	apkabinti
emerge	atsirasti
emergency	Skubus atvëjis
emerging	atsiranda
emission	emisija
emotion	emocijos
emotional	emocinis
emotionally	emociðkai
emphasis	pabrëþimas
emphasize	pabrëþti
empire	imperija
employ	ádarbinti
employee	darbuotojas
employer	darbdavys
employment	uþimtumà
empty	tuðèias
enable	ájungti
enact	priimti
encounter	susidurti
encounter	susidurti
encourage	skatinti
encouraging	skatinti
end	pabaiga
endless	begalinis
endorse	pritarti
endure	iðtverti
enemy	prieðas
energy	energijos
enforce	vykdyti
enforcement	vykdymas
engage	ásitraukti
engagement	dalyvavimas
engine	variklis
engineer	inþinierius
engineering	inþinerija
enhance	padidinti
enjoy	mëgautis
enormous	milþiniðkas
enough	pakankamai
enroll	uþsiregistruoti
ensure	uþtikrinti
enter	ávesti
enterprise	ámonë
entertainment	pramogos
enthusiasm	entuziazmas
entire	visas
entirely	visiðkai
entity	subjektas
entitle	teisë
entrance	áëjimas
entrepreneur	verslininkas
entry	áraðas
envelope	vokà
environment	aplinkà
environmental	aplinkosaugos
envision	ásivaizduokite
epidemic	epidemija
episode	epizodas
equal	lygus
equality	lygybë
equally	vienodai
equation	lygtis
equip	árengti
equipment	áranga
equity	nuosavo kapitalo
equivalent	lygiaverèiai
era	era
error	klaida
escape	pabëgti
especially	ypaè
essay	esë
essence	esmë
essential	esminis
essentially	ið esmës
establish	nustatyti
establishment	ásteigimas
estate	turtas
estimate	apskaièiuoti
estimated	apskaièiuota
etc	ir tt
ethics	Etika
ethnic	etninës
European	Europos
evaluate	ávertinti
evaluation	vertinimas
even	netgi
evening	vakare
event	ávykis
eventually	galiausiai
ever	kada nors
every	kiekvienas
everybody	visi
everyday	kiekvienà dienà
everyone	Visi
everything	viskas
everywhere	visur
evidence	árodymai
evident	akivaizdu
evil	velnias
evolution	evoliucija
evolve	vystytis
exact	tiksli
exactly	tiksliai
exam	egzaminas
examination	egzaminà
examine	iðnagrinëti
example	pavyzdys
exceed	virðyti
excellent	puikus
except	iðskyrus
exception	iðimtis
excessive	per daug
exchange	keistis
excited	susijaudinæs
excitement	jaudulys
exciting	jaudinantis
exclude	Neátraukti
exclusive	iðskirtinis
exclusively	iðimtinai
excuse	pasiteisinimas
excuse	pasiteisinimas
execute	vykdyti
execution	vykdymas
executive	vykdomasis
exercise	pratimas
exhaust	iðmetimas
exhibit	eksponuoti
exhibition	paroda
exist	egzistuoja
existence	egzistavimas
existing	esamas
exit	iðeiti
exotic	egzotiðkas
expand	iðplësti
expansion	plëtra
expect	tikëtis
expectation	lûkesèiai
expected	tikimasi
expedition	ekspedicija
expense	iðlaidos
expensive	brangus
experience	patirtis
experienced	Patyræs
experiment	eksperimentas
experimental	eksperimentinis
expert	ekspertas
explain	paaiðkinkite
explanation	paaiðkinimas
explicit	aiðkiai
explode	sprogti
exploit	iðnaudoti
exploration	þvalgymas
explore	iðtirti
explosion	sprogimas
export	eksportuoti
expose	atskleisti
exposure	poveikis
express	iðreikðti
expression	iðraiðka
extend	pratæsti
extended	pratæstas
extension	pratæsimas
extensive	platus
extent	mastu
external	iðorinis
extra	papildomai
extraordinary	nepaprastas
extreme	ekstremalus
extremely	labai
fabric	medþiaga
face	veidas
facilitate	palengvinti
facility	árenginys
fact	faktas
factor	veiksnys
factory	gamykla
faculty	fakultetas
fade	iðnyks
fail	nepavyksta
failure	nesëkmë
faint	silpnas
fair	ðviesus
fairly	teisingai
faith	tikëjimas
fall	ruduo
fame	ðlovë
familiar	susipaþinæ
family	ðeima
famous	garsus
fan	ventiliatorius
fantasy	fantazija
fantastic	fantastinis
far	toli
fare	kaina
farm	ûkis
farmer	ûkininkas
fascinating	þavinga
fashion	mada
fast	greitas
faster	greièiau
fat	storas
fatal	mirtinas
fate	likimas
father	tëvas
fatigue	nuovargis
fault	gedimas
favor	nauda
favorable	palanki
favorite	mëgstamiausias
fear	baimë
feather	plunksna
feature	bruoþas
federal	federalinis
fee	rinkliava
feed	maitinti
feedback	atsiliepimas
feel	jausti
feeling	jausmas
fellow	kolegos
female	moteris
feminist	feministas
fence	tvora
festival	festivalis
fever	karðèiavimas
few	nedaug
fewer	maþiau
fiber	pluoðto
fiction	groþinë literatûra
field	sritis
fierce	þiauriai
fifteen	penkiolika
fifth	penkta
fifty	penkiasdeðimt
fight	kovoti
fight	kovoti
fighter	kovotojas
figure	skaièius
file	failas
fill	uþpildyti
film	filmas
filter	filtras
final	galutinis
finally	pagaliau
finance	finansuoti
financial	finansinës
find	rasti
finding	iðvados
fine	gerai
finger	pirðtu
finish	baigti
fire	Ugnis
firm	firma
firmly	tvirtai
first	Pirmas
fiscal	fiskalinë
fish	þuvis
fisherman	þvejas
fishing	þvejyba
fist	kumðèiu
fit	tikti
fitness	tinkamumas
five	penki
fix	pataisyti
fixed	fiksuotas
flag	vëliava
flame	liepsna
flash	blykstë
flat	butas
flavor	skonis
flee	pabëgti
fleet	laivynas
flexibility	lankstumas
flexible	lanksti
flight	skrydis
flip	apversti
fly	skristi
flying	skraidantis
float	plûdë
flood	potvyniø
flood	potvyniø
floor	grindys
flour	miltai
flow	srautas
flower	gëlë
fluid	skystis
focus	sutelkti dëmesá
fog	rûkas
fold	lankstyti
folk	liaudies
follow	sekti
following	kitas
food	maistas
fool	kvailys
foot	pëdos
football	futbolas
for	dël
forbid	uþdrausti
force	jëga
forehead	kakta
foreign	uþsienio
foreigner	uþsienietis
forest	miðkas
forever	amþinai
forget	pamirðti
forgive	atleisk
fork	ðakutë
form	suformuoti
formal	formalus
format	formatà
formation	formavimas
former	buvæs
formerly	anksèiau
formula	formulë
forth	toliau
forty	keturiasdeðimt
fortunately	laimei
fortune	laimë
forum	forumas
forward	Persiøsti
foster	skatinti
found	rasta
foundation	fondas
founder	ákûrëjas
four	keturi
fourth	ketvirta
fraction	frakcija
fragile	trapus
fragment	fragmentas
frame	rëmas
framework	sistemà
franchise	franðizë
frankly	atvirai
fraud	sukèiavimu
free	Laisvas
freedom	laisvë
freely	laisvai
freeze	uþðaldyti
frequency	daþnis
frequent	daþnai
frequently	daþnai
fresh	ðvieþias
freshman	naujokas
friend	draugas
friendly	draugiðkas
friendship	draugystë
from	nuo
front	priekyje
frontier	pasienis
frown	átrinti
frozen	uþðaldyti
fruit	vaisiai
frustrate	ardyti
frustration	nusivylimas
fucking	suðikti
fuel	kuras
full	pilnas
fully	visiðkai
full-time	pilnas laikas
fun	linksma
fun	linksma
function	funkcija
functional	funkcionalus
fund	paremti
fundamental	esminis
funding	finansavimà
funeral	laidotuvës
funny	juokinga
fur	kailiai
furniture	baldai
furthermore	be to
future	ateityje
gain	ágyti
gay	gëjus
galaxy	galaktika
gallery	galerijoje
game	þaidimas
gang	gauja
gap	spragà
garage	garaþas
garbage	ðiukðles
garden	sodas
garlic	èesnakai
gas	dujos
gasoline	benzinas
gate	vartai
gather	rinkti
gathering	rinkimas
gaze	þvilgsnis
gear	pavara
gender	lytis
gene	genas
general	bendras
generally	apskritai
generate	generuoti
generation	karta
generous	turtinga
genetic	genetinis
genius	genijus
genre	þanras
gentle	ðvelnus
gentleman	dþentelmenas
gently	ðvelniai
genuine	tikras
German	Vokieèiø kalba
gesture	gestas
get	gauti
ghost	vaiduoklis
giant	milþinas
giant	milþinas
gift	dovanos
gifted	talentingas
girl	mergina
girlfriend	mergina
give	duoti
given	pateikta
gym	sporto salë
glad	dþiaugtis
glance	þvilgsnis
glance	þvilgsnis
glass	stiklas
glimpse	þvilgsnis
global	pasauliniu mastu
globe	gaublys
glory	ðlovë
glove	pirðtinës
go	eiti
goal	tikslas
goat	oþka
God	Dievas
gold	auksas
golden	auksinis
golf	golfas
good	geras
govern	valdyti
government	vyriausybë
governor	gubernatorius
grab	patraukti
grace	malonë
grade	klasë
gradually	palaipsniui
graduate	absolventas
graduation	baigimas
grain	grûdai
gray	pilka
grand	grand
grandchild	anûkas
grandfather	senelis
grandmother	moèiutë
grandparent	seneliai
grant	dotacija
grape	Vynuogë
grasp	suvokti
grass	þolë
grateful	dëkingas
grave	kapas
gravity	gravitacija
great	puikus
greatest	didþiausias
greatly	labai
Greek	Graikø
green	þalias
greet	pasveikint
grief	sielvartas
grin	ðypsnys
grip	rankena
grocery	maisto prekiø parduotuvë
gross	bruto
ground	þemës
group	grupæ
grow	augti
growing	augimas
growth	augimas
guarantee	garantuoti
guard	apsaugoti
guess	atspëti
guest	sveèias
guidance	rekomendacijas
guide	vadovas
guideline	gairës
guilt	kaltë
guilty	kaltas
guitar	gitara
guy	vaikinas
gun	ginklas
habit	áprotis
habitat	buveinës
hair	plaukai
hay	ðieno
half	pusë
half	pusë
halfway	pusiaukelëje
hall	salë
hallway	prieðkambaris
hand	ranka
handful	sauja
handle	rankena
handsome	graþus
hang	pakabinti
happen	atsitikti
happily	laimingai
happiness	laimë
happy	laimingas
harassment	priekabiavimas
hard	sunkus
hardware	techninë áranga
harm	þala
harmony	harmonija
harsh	grieþtas
harvest	derlius
hat	skrybëlæ
hate	nekæsti
haul	traukos
have	turëti
hazard	pavojus
He	jis
head	galva
headache	galvos skausmas
headline	antraðtë
headquarters	bûstinëje
heal	Iðgyti
health	sveikata
health-care	sveikatos apsauga
healthy	sveikas
hear	girdëti
hearing	klausymas
heart	ðirdis
heat	ðiluma
heaven	dangus
heavily	stipriai
heavy	sunkus
heel	kgyti
height	aukðtis
helicopter	sraigtasparnis
hell	pragaras
hello	Sveiki
helmet	ðalmas
help	padëti
help	padëti
helpful	naudinga
hence	taigi
her	jai
herb	þolelë
here	èia
heritage	paveldas
hero	herojus
hers	jos
herself	pati
hesitate	dvejoti
hi	labas
hidden	paslëptas
hide	paslëpti
high	aukðtas
high	aukðtas
highlight	pabrëþti
highly	labai
high-tech	aukðtøjø technologijø
hike	þygis
hill	kalnas
him	jam
himself	pats
hint	uþuomina
hip	klubas
hire	samdyti
his	jo
Hispanic	Ispaniðkas
historian	istorikas
historic	istorinis
historical	istorinis
historically	istoriðkai
history	istorija
hit	suduoti
hypothesis	hipotezë
hockey	ledo ritulys
hold	laikyti
hole	skylë
holiday	ðventë
holy	ðventa
home	namai
homeland	tëvynë
homeless	benamiai
homework	namø darbai
honey	medus
honest	nuoðirdus
honestly	sàþiningai
honor	garbë
hook	kablys
hope	viltis
horizon	horizonto
hormone	hormonas
horn	ragas
horrible	siaubingas
horror	siaubas
horse	arklys
hospital	ligoninë
host	ðeimininkas
hostage	ákaitas
hostile	prieðiðkas
hot	karðta
hotel	vieðbutis
hour	valanda
house	namas
household	namø ûkis
housing	bûstas
how	kaip
however	taèiau
hug	apkabinti
huge	didelis
human	þmogus
humanity	þmonija
humor	humoras
hundred	ðimtai
hunger	badas
hungry	alkanas
hunt	medþioti
hunter	medþiotojas
hunting	medþioklë
hurricane	uraganas
hurry	paskubëti
hurt	skauda
husband	vyras
I	að
ice	ledas
icon	piktograma
idea	idëja
ideal	idealus
identical	identiðki
identification	identifikavimas
identify	nustatyti
identity	tapatybæ
ideological	ideologinis
ideology	ideologija
ie	t.y
if	jei
ignore	ignoruoti
ill	nesveikas
illegal	neteisëtas
illness	liga
illusion	iliuzija
illustrate	iliustruoja
image	vaizdà
imagination	vaizduotë
imagine	ásivaizduokite
immediate	nedelsiant
immediately	nedelsiant
immigrant	imigrantas
immigration	imigracija
immune	imuninis
impact	poveiká
implement	ágyvendinti
implementation	ágyvendinimà
implication	reikðmës
imply	reikðti
import	importuoti
importance	svarba
important	svarbus
importantly	svarbiausia
impose	nustatyti
impossible	neámanomas
impress	nustebinti
impression	áspûdis
impressive	áspûdingas
improve	pagerinti
improved	pagerintas
improvement	pagerëjimas
impulse	impulsas
in	-
incentive	paskata
incident	incidentas
include	átraukti
including	áskaitant
income	pajamos
incorporate	átraukti
increase	padidinti
increased	padidintas
increasing	didëja
increasingly	vis labiau
incredible	neátikëtinas
incredibly	neátikëtinai
indeed	ið tikrøjø
independence	nepriklausomybë
independent	nepriklausomas
index	indeksas
Indian	Indijos
indicate	nurodyti
indication	indikacija
indicator	rodiklis
indigenous	vietinis
individual	individualus
industrial	pramonës
industry	industrija
inevitable	neiðvengiamas
inevitably	neiðvengiamai
infant	kûdikis
infection	infekcija
inflation	infliacija
influence	átaka
influential	átakingas
inform	informuoti
informal	neoficialus
information	informacija
infrastructure	infrastruktûra
ingredient	ingredientas
inherent	bûdinga
inherit	paveldëti
initial	pradinis
initially	ið pradþiø
initiate	pradëti
initiative	iniciatyva
injure	suþeisti
injury	þalos
inmate	kalinys
inner	vidinis
innocent	nekaltas
innovation	naujovës
innovative	novatoriðkas
input	ávestis
inquiry	tyrimas
insect	vabzdys
insert	Ádëti
inside	viduje
insight	áþvalga
insist	reikalauti
inspection	inspekcija
inspector	inspektorius
inspiration	ákvëpimo
inspire	ákvëpti
install	diegti
installation	diegimas
instance	instancija
instant	ið karto
instantly	ið karto
instead	vietoj to
instinct	instinktas
institution	institucija
institutional	institucinis
instruct	nurodykite
instruction	instrukcija
instructional	mokymo
instructor	instruktorius
instrument	instrumentas
insurance	draudimas
intact	nepaþeistas
integrate	integruoti
integrated	integruota
integration	integracija
integrity	vientisumas
intellectual	intelektualus
intelligence	intelektas
intelligent	protingas
intend	ketina
intense	intensyvus
intensity	intensyvumas
intent	tikslas
intention	ketinimzx
interact	bendrauti
interaction	sàveika
interest	palûkanox
interested	suinteresuotas
interesting	ádomus
interfere	trukdyti
interior	interjeras
internal	vidinis
international	tarptautiniu mastu
Internet	internetas
interpret	interpretuoti
interpretation	interpretacija
interrupt	nutraukti
interval	intervalas
intervention	intervencijos
interview	interviu
intimate	intymûs
into	á
introduce	pristatyti
introduction	ávadas
invade	ásiverþti
invasion	invazija
invent	sugalvoti
invention	iðradimas
inventory	inventorius
invest	investuoti
investigate	iðtirti
investigation	tyrimas
investigator	tyrëjas
investment	investicijas
investor	investuotojas
invisible	nematomas
invitation	kvietimas
invite	pakviesti
involve	Átraukti
involved	átrauktas
involvement	dalyvavimas
iron	geleþies
ironically	ironiðkai
irony	ironija
Islam	Islamas
island	sala
isolate	izoliuoti
isolated	izoliuotas
isolation	izoliacija
Israeli	Izraelis
issue	klausimas
it	tai
Italian	Italø kalba
item	elementas
its	jo
itself	pats
yard	kiemas
year	metai
yell	ðaukti
yellow	geltona
yes	taip
yesterday	vakar
yet	dar
yield	derlius
You	tas
young	jauni
youngster	jaunuolis
your	tavo
yours	tavo
yourself	patys
youth	jaunimas
jacket	striukë
jail	kalëjime
Japanese	Japonø kalba
jar	stiklainis
jaw	þandikaulá
jazz	dþiazas
jeans	dþinsai
jet	reaktyvinis
Jew	Þydas
jewelry	papuoðalai
Jewish	Þydø
job	darbas
join	prisijungti
joint	Bendras
joy	dþiaugsmas
joke	pokðtas
journal	þurnalas
journalism	þurnalistika
journalist	þurnalistas
journey	kelionë
judge	teisëjas
judgment	sprendimas
judicial	teisminës institucijos
juice	sultys
jump	ðokinëti
jungle	dþiunglëse
junior	jaunesnysis
jurisdiction	jurisdikcija
jury	þiuri
juror	teisëjas
just	tiesiog
justice	teisingumas
justify	pateisinti
keep	iðlaikyti
key	Raktas
kick	smûgis
kid	vaikas
kill	nuþudyti
killer	þudikas
killing	þudymas
kind	malonus
king	karalius
kingdom	karalystë
kiss	pabuèiuoti
kit	rinkinys
kitchen	virtuvë
knee	kelio
kneel	nuleisti
knife	peilis
knock	belsti
know	þinoti
knowledge	þinios
known	þinomas
lab	laboratorija
label	etiketë
labor	darbo
laboratory	laboratorija
lack	trûksti
ladder	kopëèios
lady	ponia
lay	gulëti
layer	sluoksnis
lake	eþeras
lamp	lempa
land	þemë
landing	nusileidimas
landmark	orientyras
landscape	kraðtovaizdá
lane	juosta
language	kalba
lap	ratas
large	didelis
largely	daugiausia
laser	lazeris
last	paskutinis
late	vëlai
lately	pastaruoju metu
later	vëliau
Latin	Lotynø
latter	pastarasis
laugh	juoktis
laughter	juokas
launch	pradëti
laundry	skalbiniai
law	teisë
lawyer	teisininkas
lawmaker	ástatymø leidëjas
lawn	veja
lawsuit	ieðkinys
lead	vadovauti
leader	lyderis
leadership	vadovavimas
leading	pirmaujantis
leaf	lapai
league	lygoje
lean	liesas
leap	ðuolis
learn	mokytis
learning	mokymasis
least	maþiausiai
leather	oda
leave	palikti
lecture	paskaita
left	kairëje
leg	koja
legacy	palikimas
legal	teisëtas
legally	teisëtai
legend	legenda
legislation	teisës aktus
legislative	teisëkûros
legislator	ástatymø leidëjas
legislature	teisës aktø leidëjo
legitimate	teisëtas
lemon	citrina
lend	skolinti
length	ilgis
lens	objektyvas
less	maþiau
lesson	pamoka
let	leisti
letter	laiðkas
level	lygis
liability	atsakomybë
liberal	liberalus
liberty	laisvæ
library	biblioteka
license	licencija
lid	dangtelis
lie	melas
life	gyvenimas
lifestyle	gyvenimo bûdas
lifetime	gyvenimas
lift	liftas
light	ðviesa
lighting	apðvietimas
lightly	lengvai
lightning	þaibas
like	Kaip
likelihood	tikimybë
likely	tikëtina
likewise	taip pat
limb	galûnë
limit	riba
limitation	apribojimas
limited	ribotas
line	linija
link	nuoroda
lion	liûtas
lip	lûpa
liquid	skystis
list	sàraðas
listen	klausykitës
listener	klausytojas
literally	paþodþiui
literary	literatûros
literature	literatûra
little	maþai
live	gyventi
liver	kepenys
living	gyvenimas
load	apkrauti
loan	paskola
lobby	lobis
local	vietos
locate	suraskite
location	vieta
lock	uþrakinti
log	þurnalas
logic	logika
logical	logiðka
loyal	iðtikimas
loyalty	lojalumas
lonely	vieniðas
long	ilgai
long-term	ilgas terminas
longtime	ilgas laikas
look	atrodyti
loop	kilpa
loose	laisvas
lose	prarasti
loss	nuostolis
lost	prarado
lot	daug
loud	garsiai
love	mylëti
lovely	mielas
lover	meiluþis
low	þemas
lower	maþesnis
luck	sëkmë
lucky	pasisekë
lunch	pietûs
lung	plauèiø
machine	maðina
mad	piktas
magazine	þurnalas
magic	magija
magnetic	magnetinis
magnitude	dydid
mail	Paðtas
main	pagrindinis
mainly	daugiausia
mainstream	pagrindinë
maintain	iðlaikyti
maintenance	prieþiûra
may	geguþë
maybe	gal bût
mayor	meras
major	pagrindinis
majority	dauguma
make	padaryti
maker	gamintojas
makeup	makiaþas
male	vyras
mall	prekybos centras
man	vyras
manage	valdyti
management	valdymas
manager	vadybininkas
managing	valdyti
mandate	mandatas
manipulate	manipuliuoti
many	daug
manner	bûdas
mansion	dvaras
manual	vadovas
manufacturer	gamintojas
manufacturing	gamyba
map	þemëlapis
marble	marmuras
march	Kovas
margin	marþa
marine	jûrø
mark	paþymëti
marker	þymeklis
market	turgus
marketing	rinkodara
marketplace	rinkoje
marriage	santuoka
married	Vedæs
marry	tuoktis
mask	kaukë
mass	masë
massive	masyvi
master	kapitonas
match	rungtynës
mate	draugas
material	medþiaga
math	matematika
mathematics	matematika
matter	klausimas
maximum	maksimaliai
me	man
meal	valgis
mean	reiðkia
meaning	prasme
meaningful	reikðmingas
meantime	kol kas
meanwhile	tuo tarpu
measure	priemonë
measurement	matavimas
meat	mësa
mechanic	mechanikas
mechanical	mechaniniai
mechanism	mechanizmas
medal	medalis
media	þiniasklaida
medical	medicinos
medication	vaistas
medicine	medicina
medium	terpëje
meet	susitikti
meeting	posëdis
melt	lydyti
member	narys
membership	narystë
memory	atminties
mental	protinis
mentally	protiðkai
mention	paminëti
mention	paminëti
mentor	mentorius
menu	Meniu
merchant	prekybininkas
mere	tik
merely	tik
merit	nuopelnus
mess	netvarka
message	praneðimas
metal	metalo
metaphor	metafora
meter	metras
method	metodas
metropolitan	didmiestis
Mexican	Meksikos
middle	vidurys
middle-class	vidurinë klasë
midnight	vidurnaktis
midst	viduryje
might	galbût
migration	migracija
mild	ðvelnus
military	karinis
milk	pienas
mill	malûnas
million	milijonas
mind	protas
mine	mano
mineral	mineralinis
minimal	minimalus
minimize	sumaþinti
minimum	minimumas
minister	ministras
ministry	ministerija
minor	nepilnametis
minority	maþuma
minute	minutë
miracle	stebuklas
mirror	veidrodis
miss	praleisti
missile	raketos
missing	dingæs
mission	misija
missionary	misionierius
mistake	klaida
mix	sumaiðyti
mixed	sumaiðytas
mixture	miðinys
my	mano
myself	að pats
mysterious	máslingas
mystery	paslaptis
myth	mitas
mobile	mobiliojo ryðio
mode	reþimu
model	modelis
moderate	vidutinio sunkumo
modern	modernus
modest	kuklus
modify	keisti
molecule	molekulës
mom	mama
moment	momentas
momentum	pagreitis
money	pinigai
monitor	stebëti
monitor	stebëti
monkey	beþdþionë
monster	monstras
month	mënesis
monthly	kas mënesá
monument	paminklas
mood	nuotaika
moon	mënulis
moral	moralinis
more	daugiau
moreover	be to
morning	ryte
mortality	mirtingumas
mortgage	hipotekos
most	labiausiai
mostly	daþniausiai
mother	motina
motion	judëjimas
motivate	motyvuoti
motivation	motyvacija
motive	motyvas
motor	variklis
mount	kalno
mountain	kalnas
mouse	pelë
mouth	Burna
move	judëti
movement	judëjimas
movie	filmas
Mr	Ponas
Mrs	Ponia
much	daug
mud	purvas
multiple	daugkartinis
municipal	savivaldybës
murder	þmogþudystë
muscle	raumenys
museum	muziejus
mushroom	grybai
music	muzika
musical	muzikinis
musician	muzikantas
Muslim	Musulmonai
must	turi
mutter	sukrëtimas
mutual	tarpusavio
nail	vinis
naked	nuogas
name	vardas
narrative	pasakojimas
narrow	siauras
nasty	bjaurus
nation	tauta
national	nacionalinis
nationwide	visoje ðalyje
native	gimtoji
natural	natûralus
naturally	natûraliai
nature	pobûdis
naval	laivynas
near	arti
nearby	netoliese
nearly	beveik
neat	tvarkingas
necessarily	bûtinai
necessary	bûtina
necessity	bûtinybë
neck	kaklas
need	reikia
needle	adata
negative	neigiamas
negotiate	derëtis
negotiation	derybos
neighbor	kaimynas
neighborhood	kaimynystëje
neighboring	kaimyninës
neither	taip pat
nerve	nervas
nervous	nervingas
nest	lizdas
net	tinklas
network	tinklas
neutral	neutralus
never	niekada
nevertheless	vis dëlto
new	naujas
newly	naujai
news	þinios
newspaper	laikraðtis
next	Kitas
nice	malonu
night	naktis
nightmare	koðmaras
nine	devyni
no	ne
nobody	niekas
noise	triukðmas
nomination	nominacija
nominee	kandidatas
none	në vienas
nonetheless	vis dëlto
nonprofit	nepelno
noon	vidurdiená
nor	nei
norm	norma
normal	normalus
normally	paprastai
north	Ðiaurë
northeast	á ðiaurës rytus
northern	ðiaurëje
northwest	Ðiaurës vakarai
nose	nosis
not	ne
note	pastaba
notebook	uþraðø knygutë
nothing	nieko
notice	pastebëti
notion	sàvoka
novel	romanas
now	dabar
nowhere	niekur
nuclear	branduolinës energijos
number	numeris
numerous	gausus
nurse	slaugytoja
nut	verþlë
nutrient	maistiniø medþiagø
oak	àþuolas
object	objektas
objection	prieðtaravimas
objective	tikslas
obligation	ásipareigojimas
observation	stebëjimas
observe	stebëti
observer	stebëtojas
obstacle	kliûtis
obtain	gauti
obvious	aiðkus
obviously	akivaizdu
occasion	proga
occasional	retkarèiais
occasionally	kartais
occupation	profesija
occupy	uþimti
occur	atsiranda
ocean	vandenynas
o'clock	valandà
odd	keista
odds	ðansai
of	-
off	iðjungtas
offender	nusikaltëlis
offense	nusikaltimas
offensive	agresyvus
offer	pasiûlymas
offering	pasiûlymas
office	biuras
officer	pareigûnas
official	pareigûnas
officially	oficialiai
often	daþnai
oil	aliejus
ok	Gerai
okay	Gerai
old	senas
old-fashioned	senamadiðkas
Olympic	Olimpinës
Olympics	Olimpinës þaidynës
on	ájungtas
once	kartà
one	vienas
one-third	viena treèioji
ongoing	vyksta
onion	svogûnas
online	prisijungæs
only	tik
onto	ant
open	atviras
opening	atidarymas
openly	atvirai
opera	operos
operate	veikia
operating	veikia
operation	operacija
operator	operatorius
opinion	nuomonæ
opponent	prieðininkas
opportunity	galimybæ
oppose	prieðtarauja
opposed	prieðinosi
opposite	prieðingas
opposition	opozicija
opt	pasirinkti
optimistic	optimistiðkas
option	parinktis
or	arba
oral	þodþiu
orange	oranþinë
orbit	Orbita
order	ásakymas
ordinary	paprastas
organ	organas
organic	ekologiðkas
organism	organizmas
organization	organizacija
organizational	organizaciniai
organize	organizuoti
organized	organizuotas
orientation	orientacija
origin	kilmæ
original	originalus
originally	ið pradþiø
other	kita
others	kiti
otherwise	kitaip
ought	turëtø
our	mûsø
ourselves	mes patys
out	-
outcome	rezultatas
outdoor	lauke
outer	iðorinis
outfit	apranga
outlet	lizdas
outline	kontûras
output	iðvestis
outside	iðorëje
outsider	paðalinis
outstanding	iðskirtinis
oven	orkaitë
over	daugiau
overall	apskritai
overcome	áveikti
overlook	nepastebëkite
overnight	per naktá
oversee	priþiûrëti
overwhelm	uþvaldyti
overwhelming	didþiulis
owe	skolingi
own	savo
owner	savininkas
ownership	nuosavybë
oxygen	deguonies
pace	tempas
pack	pakuoti
package	paketas
pad	padas
page	puslapis
pain	skausmas
painful	skausmingas
paint	tapyti
painter	tapytojas
painting	paveikslas
pair	pora
pay	sumokëti
payment	mokëjimas
palace	rûmai
pale	ðviesiai
palm	delnas
panel	skydelis
panic	panika
pant	alsuoti
paper	popieriaus
parade	paradas
parent	tëvai
parental	tëvø
parish	parapija
park	parkas
parking	automobiliø stovëjimo aikðtelë
part	dalis
partial	dalinis
partially	ið dalies
participant	dalyvis
participate	dalyvauti
participation	dalyvavimas
particle	dalelë
particular	ypaè
party	vakarëlis
partly	ið dalies
partner	partneris
partnership	partnerystë
pass	praeiti
passage	iðtrauka
passenger	keleivis
passing	praeiti
passion	aistra
past	praeitis
pasta	makaronai
pastor	pastorius
patch	pleistras
patent	patentas
path	kelias
patience	kantrybë
patient	pacientas
patrol	patrulis
patron	globëjas
pattern	modelis
pause	Pauzë
peace	taika
peaceful	taikûs
peak	pikas
peanut	þemës rieðutai
peasant	valstietis
peel	þievelës
peer	bendraamþis
pen	tuðinukas
penalty	bauda
pencil	pieðtukas
pension	pensijà
people	þmoniø
pepper	pipirø
per	uþ
perceive	suvokti
perceived	suvokiama
percentage	procentais
perception	suvokimas
perfect	tobulas
perfectly	puikiai
perform	atlikti
performance	spektaklis
performer	atlikëjas
perhaps	galbût
period	laikotarpá
permanent	nuolatinis
permission	leidimas
permit	leidimas
permit	leidimas
Persian	Persø kalba
persist	iðlieka
person	asmuo
personal	Asmeninis
personality	asmenybë
personally	asmeniðkai
personnel	personalas
perspective	perspektyva
persuade	átikinti
pet	naminis gyvûnëlis
phase	etapas
phenomenon	reiðkinys
philosophical	filosofinis
philosophy	filosofija
physical	fizinis
physically	fiziðkai
physician	gydytojas
physics	fizika
phone	telefonas
photo	nuotrauka
photograph	nuotrauka
photographer	Fotografas
photography	fotografija
phrase	frazë
piano	fortepijonas
pick	pasiimti
pickup	paimti
picture	vaizdas
pie	pyragas
piece	gabalas
pig	kiaulë
pile	krûva
pile	krûva
pill	tabletes
pillow	pagalvë
pilot	pilotas
pin	kaiðtis
pine	puðis
pink	roþinis
pioneer	pradininkas
pipe	vamzdis
pistol	pistoletas
pit	duobë
pitch	pikis
pitcher	àsotis
pizza	pica
place	vieta
placement	vieta
plain	paprastas
plaintiff	ieðkovas
play	þaisti
player	grotuvas
playoff	atkûrimo
plan	planuoti
plane	plokðtuma
planet	planeta
planner	planuotojas
planning	planavimas
plant	augalas
plastic	plastmasinis
plate	plokðtë
platform	platforma
plea	pagrindas
plead	praðyti
pleasant	malonus
please	Praðau
pleasure	malonumas
plenty	daug
plot	sklypas
plunge	pasinerti
plus	plius
pocket	kiðenëje
poem	eilëraðtis
poet	poetas
poetry	poezija
point	taðkas
pole	polius
police	policija
policeman	policininkas
policy	politika
political	politinis
politically	politiðkai
politician	politikas
politics	politika
poll	apklausa
pollution	tarða
pond	tvenkinys
pool	baseinas
poor	vargðas
popular	populiarus
popularity	populiarumas
population	populiacija
porch	veranda
pork	kiauliena
port	uostas
portion	dalis
portrait	portretas
portray	pavaizduoti
position	pozicija
positive	teigiamas
possess	turëti
possession	valdymà
possibility	galimybë
possible	ámanoma
possibly	galbût
post	paðtas
poster	plakatas
pot	puodas
potato	bulvë
potential	potencialus
potentially	potencialiai
pound	svaras
pour	supilkite
poverty	skurdas
powder	milteliai
power	galia
powerful	galingas
practical	praktiðkas
practically	praktiðkai
practice	praktika
practitioner	gydytojas
praise	pagirti
pray	melskitës
prayer	malda
preach	skelbkite
precious	brangus
precise	tikslus
precisely	tiksliai
predator	plëðrûnas
predict	numatyti
prediction	prognozavimas
prefer	nori
preference	pirmenybë
pregnancy	nëðtumas
pregnant	nëðèia
preliminary	preliminarus
premise	prielaida
premium	premija
preparation	paruoðimas
prepare	pasiruoðti
prescription	receptas
presence	buvimas
present	pateikti
present	pateikti
present	pateikti
presentation	pristatymas
preserve	iðsaugoti
presidency	pirmininkavimas
president	pirmininkas
presidential	prezidento
press	paspausti
pressure	slëgis
presumably	tikriausiai
pretend	apsimesti
pretty	graþi
prevail	vyrauti
prevent	uþkirsti kelià
prevention	prevencija
previous	ankstesnis
previously	anksèiau
price	kaina
pride	pasididþiavimas
priest	kunigas
primarily	visø pirma
primary	pirminë
prime	pagrindinis
principal	principas
principle	principas
print	spausdinti
prior	anksèiau
priority	prioritetas
prison	kalëjimas
prisoner	kalinys
privacy	privatumas
private	privatus
privately	privaèiai
privilege	privilegija
prize	prizas
probably	tikriausiai
problem	problema
procedure	procedûra
proceed	tæsti
process	procesas
processing	apdorojimas
processor	procesorius
proclaim	skelbti
produce	gaminti
producer	gamintojas
product	produktas
production	gamyba
productive	produktyvus
productivity	produktyvumas
profession	profesija
professional	profesionalus
professor	profesorius
profile	profilis
profit	pelnas
profound	giliai
program	programa
programming	programavimas
progress	progresas
progressive	palaipsniui
prohibit	uþdrausti
project	projektas
projection	projekcija
prominent	pastebimas
promise	paþadas
promising	perspektyvus
promote	skatinti
promotion	skatinimas
prompt	greitai
proof	árodymas
proper	tinkamas
properly	tinkamai
property	nuosavybë
proportion	proporcingai
proposal	pasiûlymas
propose	pasiûlyti
proposed	siûloma
prosecution	baudþiamasis persekiojimas
prosecutor	kaltintojas
prospect	perspektyva
protect	apsaugoti
protection	apsauga
protective	apsauginë
protein	baltymas
protest	protestuoti
protocol	protokolas
proud	didþiuojasi
prove	árodyti
provide	teikti
provided	jeigu
provider	teikëjas
province	provincijoje
provision	nuostata
provoke	iðprovokuoti
psychological	psichologinis
psychologist	psichologas
psychology	psichologija
public	visuomenë
publication	paskelbimas
publicity	vieðumas
publicly	vieðai
publish	skelbti
publisher	leidëjas
pull	traukti
pulse	pulsas
pump	siurblys
punch	smûgis
punish	nubausti
punishment	bausmë
purchase	pirkti
pure	grynas
purple	violetinë
purpose	tikslas
purse	piniginë
pursue	siekti
pursuit	siekimas
push	stumti
put	ádëti
puzzle	galvosûkis
qualify	gauti
quality	kokybë
quantity	kiekis
quarter	ketvirtis
queen	karalienë
quest	ieðkojimas
question	klausimas
questionnaire	klausimynas
quick	greitai
quickly	greitai
quiet	tyliai
quietly	tyliai
quit	mesti
quite	gana
quote	cituoti
rabbit	triuðis
race	lenktynës
racial	rasinës
racism	rasizmas
rack	stovas
radar	radaras
radiation	spinduliuotës
radical	radikaliai
radio	radijo
rage	pyktis
rail	geleþinkelio
railroad	geleþinkelis
rain	lietus
raise	pakelti
rally	ralyje
ranch	sodyba
random	atsitiktinai
range	diapazonas
rank	rangas
rape	iðprievartavimas
rapid	greitai
rapidly	greitai
rare	retas
rarely	retai
rat	þiurkë
rate	norma
rather	greièiau
rating	ávertinimas
ratio	santykis
rational	racionalus
raw	neapdorotas
reach	pasiekti
react	reaguoti
reaction	reakcija
read	skaityti
reader	skaitytojui
readily	lengvai
reading	skaitymas
ready	pasiruoðæs
real	tikras
realistic	realus
reality	tikrovë
realize	suprasti
really	tikrai
realm	sritis
rear	gale
reason	prieþastis
reasonable	pagrástas
rebel	sukilëliai
rebuild	atstatyti
recall	prisiminti
receive	gauti
receiver	imtuvas
recent	neseniai
recently	pastaruoju metu
reception	priëmimas
recession	nuosmukis
recipe	receptas
recipient	Gavëjas
recognition	pripaþinimà
recognize	atpaþinti
recommend	rekomenduoti
recommendation	rekomendacija
record	áraðas
recording	áraðymas
recover	atsigauti
recovery	atsigavimas
recruit	ádarbinti
red	raudona
reduce	sumaþinti
reduction	sumaþinimas
refer	nurodykite
reference	nuoroda
reflect	atspindëti
reflection	atspindys
reform	reformà
refrigerator	ðaldytuvas
refuge	prieglobstis
refugee	pabëgëlis
refuse	atsisakyti
regain	atgauti
regard	atþvilgiu
regarding	apie
regardless	nepriklausomai
regime	reþimà
region	regionas
regional	regioninis
register	Registruotis
regret	apgailestauju
regular	reguliariai
regularly	reguliariai
regulate	reguliuoti
regulation	reglamentavimas
regulator	reguliatorius
regulatory	reguliavimo
rehabilitation	reabilitacija
reinforce	sustiprinti
reject	atmesti
relate	susieti
related	susijæs
relation	santykis
relationship	santykiai
relative	giminaitis
relatively	santykinai
relax	atsipalaiduoti
release	iðleisti
relevant	Aktualus
reliability	patikimumas
reliable	patikimas
relief	palengvëjimas
relieve	atleisti
religion	religija
religious	religinës
rely	pasitikëti
reluctant	nenoriai
remain	lieka
remaining	likæ
remark	pastaba
remarkable	puikus
remember	Prisiminti
remind	priminti
reminder	priminimas
remote	Nuotolinis
removal	paðalinimas
remove	paðalinti
render	padaryti
rent	nuoma
rent	nuoma
rental	nuoma
repair	remontas
repair	remontas
repeat	pakartokite
repeatedly	pakartotinai
replace	pakeisti
replacement	pakeisti
reply	atsakymas
report	ataskaita
reportedly	praneðama
reporter	reporteris
reporting	ataskaitø teikimas
represent	atstovauti
representation	atstovavimas
representative	atstovas
republic	respublika
republican	respublikinis
reputation	reputacija
request	praðymas
require	reikalauti
required	reikalaujama
requirement	reikalavimas
rescue	gelbëti
research	mokslinius tyrimas
researcher	tyrëjas
resemble	panaðûs
reservation	rezervacija
reserve	uþrezervuoti
residence	gyvenamoji vieta
resident	gyventojas
residential	gyvenamasis
resign	pasitraukti
resist	atsispirti
resistance	atsparumas
resolution	rezoliucija
resolve	iðspræsti
resort	kurortas
resource	iðtekliai
respect	gerbti
respectively	atitinkamai
respond	atsakyti
respondent	respondentas
response	atsakas
response	atsakas
responsibility	atsakomybë
responsible	atsakingas
rest	poilsis
restaurant	restoranas
restore	atkurti
restrict	apriboti
restriction	apribojimas
result	rezultatas
resume	tæsti
retail	maþmeninë
retailer	maþmenininkas
retain	iðlaikyti
retire	iðeiti á pensijà
retired	iðëjæs á pensijà
retirement	iðëjimas á pensijà
retreat	trauktis
return	gráþti
reveal	atskleisti
revelation	apreiðkimas
revenue	pajamø
reverse	atvirkðèiai
review	perþiûra
revolution	revoliucija
revolutionary	revoliucinis
reward	atlygis
rhetoric	retorika
rhythm	ritmas
rib	ðonkaulis
ribbon	juosta
rice	ryþiai
rich	turtingas
rid	atsikratyti
ride	vaþiuoti
rider	vairuotojas
ridiculous	juokinga
rifle	ðautuvas
right	teisë
rim	ratlankis
ring	þiedas
riot	riauðës
rip	iðtrinti
rise	kilti
risk	rizika
risky	rizikinga
ritual	ritualas
rival	varþovas
river	upë
road	kelias
robot	robotas
rock	akmuo
rocket	raketa
rod	strypas
royal	karaliðkas
role	vaidmená
roll	ritinys
roll	ritinys
rolling	valcavimas
Roman	Romos
romance	romantika
romantic	romantiðkas
roof	stogas
room	kambarys
root	ðaknis
rope	virvë
rose	pakilo
rough	ðiurkðtus
roughly	maþdaug
round	turas
route	marðrutas
routine	rutina
routinely	reguliariai
row	eilë
rub	patrinti
rubber	guma
ruin	sugadinti
rule	taisyklë
rumor	gandas
run	paleisti
runner	bëgikas
running	veikti
rural	kaimo
rush	skubëti
Russian	Rusø
sack	maiðas
sacred	ðventa
sacrifice	paaukoti
sad	liûdnas
safe	saugus
safely	saugiai
safety	saugumas
sail	plaukti
say	sakykite
sake	labui
salad	salotos
salary	atlyginimas
sale	parduoti
sales	pardavimai
salmon	laðiða
salt	druska
same	tas pats
sample	mëginys
sanction	sankcija
sand	smëlis
sandwich	sumuðtinias
satellite	palydovà
satisfaction	pasitenkinimas
satisfy	Patenkinti
sauce	padaþas
save	sutaupyti
saving	taupymas
scale	skalë
scan	nuskaityti
scandal	skandalas
scare	panika
scared	bijo
scary	baugus
scatter	iðsklaidyti
scenario	scenarijus
scene	scenoje
scent	kvapas
schedule	tvarkaraðtis
scheme	schema
scholar	mokslininkas
scholarship	stipendija
school	mokykloje
science	mokslas
scientific	mokslo
scientist	mokslininkas
scope	taikymo sritis
score	rezultatas
scramble	peðtynës
scratch	nulio
scream	rëkti
screen	ekranas
screening	patikrinimas
screw	varþtas
script	scenarijus
sculpture	skulptûra
sea	jûros
seal	antspaudas
search	Paieðka
season	sezonas
seat	sëdynë
second	antra
secondary	antrinis
secret	paslaptis
secretary	sekretorius
section	skyrius
sector	sektorius
secular	pasaulietinë
secure	saugus
secure	saugus
security	saugumas
see	pamatyti
seed	sëklos
seek	Ieðkoti
seem	atrodo
seemingly	atrodo
segment	segmentas
seize	konfiskuoti
seldom	retai
select	pasirinkite
selected	pasirinkta
selection	pasirinkimas
self	savarankiðkai
self-esteem	savigarba
sell	parduoti
seller	pardavëjas
seminar	seminaras
Senate	Senatas
senator	senatorius
send	siøsti
senior	vyresnysis
senior	vyresnysis
sensation	pojûtis
sense	jausti
sensitive	jautrus
sensitivity	jautrumas
sensor	jutiklis
sentence	sakinys
sentiment	nuotaikos
separate	atskirai
separation	atskyrimas
sequence	seka
series	serijos
serious	rimtas
seriously	rimtai
servant	tarnas
serve	tarnauti
service	paslauga
serving	tarnauja
session	sesijos metu
set	nustatyti
setting	nustatymas
settle	atsiskaityti
settlement	atsiskaitymas
seven	septyni
seventh	septintas
several	keli
severe	sunkus
severely	grieþtai
sex	seksas
sexy	seksualus
sexual	seksualinis
sexuality	seksualumas
sexually	seksualiai
shade	atspalvis
shadow	ðeðëlis
shake	purtyti
shall	turi
shallow	sekli
shame	gëda
shape	figûra
share	Dalintis
shared	bendras
shareholder	akcininkas
shark	ryklys
sharp	aðtrus
sharply	smarkiai
she	ji
shed	mesti
sheep	aviø
sheer	grynas
sheet	lapas
shelf	lentyna
shell	apvalkalas
shelter	pastogë
shift	pamaina
shine	ðviesti
ship	laivas
shirt	marðkinëliai
shit	ðûdas
shy	drovus
shock	ðokas
shoe	batø
shoot	ðaudyti
shooting	Ðaudymas
shop	parduotuvë
shopping	apsipirkti
shore	Krantas
short	trumpas
shortage	trûkumas
shortly	netrukus
shorts	ðortai
short-term	trumpalaikis
shot	nuðautas
should	turëtø
shoulder	petys
shout	ðaukti
shove	stumti
show	Rodyti
shower	duðas
shrimp	krevetës
shrink	susitraukti
shrug	shrug
shut	Uþdaryti
sibling	broliai
sick	serga
side	pusëje
sidewalk	ðaligatvis
sigh	atodûsis
sight	regëjimas
sign	þenklas
signal	signalas
signature	paraðas
significance	reikðmæ
significant	reikðmingas
significantly	gerokai
silence	tyla
silent	tylus
silk	ðilkas
silly	kvailas
silver	sidabras
similar	panaðus
similarity	panaðumas
similarly	panaðiai
simple	paprasta
simply	tiesiog
simultaneously	tuo paèiu metu
sin	nuodëmë
since	nuo
sing	dainuoti
singer	dainininkë
single	vienas
sink	kriauklë
sir	pone
sister	sesuo
sit	sëdëti
site	svetainëje
situation	situacijà
six	ðeðios
sixth	ðeðta
size	dydis
symbol	simbolis
symbolic	simbolinë
sympathy	uþuojauta
symptom	simptomas
syndrome	sindromas
system	sistema
ski	slidinëjimas
skill	ágûdþiø
skilled	kvalifikuoti
skin	oda
skip	praleisti
skirt	sijonas
sky	dangus
skull	kaukolë
slave	vergas
slavery	vergovë
sleep	miegoti
sleeve	rankovë
slice	gabalas
slide	skaidrë
slight	nedidelis
slightly	Lengvai
slip	slydimas
slope	nuolydis
slow	lëtai
small	maþas
smart	protingas
smell	kvapas
smile	ðypsena
smoke	rûkyti
smooth	sklandþiai
snake	gyvatë
snap	snap
sneak	sëlinti
snow	sniegas
so	taigi
soak	mirkyti
soap	muilas
soar	pakilti
so-called	vadinamasis
soccer	futbolas
social	socialinis
socially	socialiai
society	visuomenei
sock	kojinës
sodium	natris
sofa	sofa
soft	minkðtas
soften	suminkðtinti
softly	ðvelniai
software	programinë áranga
soil	dirvoþemis
solar	saulës energija
soldier	kareivis
sole	padas
solely	tik
solid	kietas
solution	sprendimas
solve	iðspræsti
some	kai kurie
somebody	kaþkas
someday	kada nors
somehow	kaþkaip
someone	kaþkas
something	kaþkas
sometime	kartais
sometimes	kartais
somewhat	ðiek tiek
somewhere	kaþkur
son	sûnus
song	daina
soon	netrukus
sophisticated	sudëtingas
sorry	atsipraðau
sort	rûðiuoti
soul	siela
sound	garsas
soup	sriuba
source	ðaltinis
south	á pietus
southeast	á pietryèius
southern	pietus
southwest	á pietvakarius
sovereignty	suverenitetas
space	erdvë
Spanish	Ispanø
spare	atsarginës
spark	kibirkðtis
speak	kalbëti
speaker	garsiakalbis
special	ypatingas
specialist	specialistas
specialize	specializuojasi
specialty	specialybë
species	rûðis
specific	specifinis
specifically	konkreèiai
specify	nurodyti
spectacular	áspûdingas
spectrum	spektrà
speculate	spëlioti
speculation	spekuliacija
speech	kalba
speed	greitis
spell	raðybos
spend	iðleisti
spending	iðlaidos
sphere	sfera
spill	iðsiliejimas
spin	nugara
spine	stuburas
spirit	dvasia
spiritual	dvasinis
spy	ðnipas
split	suskaidytas
spokesman	atstovas
sponsor	rëmëjas
spoon	ðaukðtas
sport	Sportas
spot	vieta
spouse	sutuoktinis
spray	purðkalas
spread	iðplisti
spring	pavasaris
sprinkle	pabarstyti
squad	bûrys
square	kvadratas
stability	stabilumas
stable	stabilus
stack	kaminas
stadium	stadionas
staff	darbuotojai
stage	etapas
stair	laiptas
stay	likti
stance	pozicija
stand	stovëti
standard	standartas
standing	stovëjimas
star	þvaigþdë
stare	spoksoti
start	pradëti
starting	pradþia
state	bûsena
statement	pareiðkimas
station	stotis
statistical	statistikos
statistics	statistinius duomenis
statue	statula
status	statusas
statute	statutas
steadily	nuolat
steady	nuolat
steak	kepsnys
steal	pavogti
steam	garai
steel	plieno
steep	staèias
steer	vairuoti
stem	stiebas
step	þingsnis
stereotype	stereotipas
stick	klijuoti
stiff	standus
still	vis dar
stimulate	skatinti
stimulus	stimulas
stir	maiðykite
style	stilius
stomach	skrandis
stone	akmuo
stop	sustabdyti
storage	saugojimas
store	saugoti
story	istorija
storm	audra
stove	viryklë
straight	tiesiai
straighten	iðtiesinkite
strain	ðtamas
strange	keista
stranger	svetimas
strategic	strateginis
strategy	strategija
straw	ðiaudai
stream	srautas
street	gatvë
strength	jëga
strengthen	stiprinti
stress	stresas
stretch	ruoþas
strict	grieþtas
strictly	grieþtai
strike	streikas
striking	ryðkus
string	eilutë
strip	juosta
stroke	insultas
strong	stiprus
strongly	stipriai
structural	struktûriniai
structure	struktûra
struggle	kova
student	studentas
studio	studija
study	mokytis
stuff	dalykø
stuff	dalykø
stumble	suklupti
stupid	kvailas
subject	tema
submit	Pateikti
subsequent	vëliau
subsidy	subsidija
substance	medþiagos
substantial	didelë
substantially	ið esmës
subtle	subtilus
suburb	priemiestis
suburban	priemiesèio
succeed	sëkmingai
success	sëkmë
successful	sëkmingai
successfully	sëkmingai
such	toks
suck	èiulpti
sudden	staigus
suddenly	staiga
sue	iðkelti bylà
suffer	kentëti
suffering	kanèios
sufficient	pakanka
sugar	cukraus
suggest	pasiûlyti
suggestion	pasiûlymas
suicide	saviþudybë
suit	kostiumas
suitable	tinkamas
suite	apartamentai
sum	suma
summary	santrauka
summer	vasara
sun	saulë
sunlight	saulës ðviesa
sunny	saulëtas
superior	pranaðesnis
supermarket	prekybos centras
supervisor	vadovas
supplier	tiekëjas
supply	tiekimas
support	parama
supporter	rëmëjas
supportive	palaikantis
suppose	manau
supposed	manoma
supposedly	tariamai
Supreme	Aukðèiausiasis
sure	tikrai
surface	pavirðius
surgeon	chirurgas
surgery	operacija
surprise	staigmena
surprised	nustebintas
surprising	stebina
surprisingly	stebëtinai
surround	apsupti
surrounding	aplinkui
surveillance	prieþiûra
survey	apklausa
survival	iðlikimas
survive	iðgyventi
survivor	iðgyvenæs
suspect	átariamasis
suspect	átariamasis
suspend	sustabdyti
suspicion	átarimas
suspicious	átartinas
sustain	palaikyti
sustainable	tvarus
swallow	nuryti
swear	prisiekti
sweat	prakaitas
sweater	megztinis
sweep	valyti
sweet	saldus
swell	iðsipûsti
swim	plaukti
swimming	plaukimas
swing	sûpynës
switch	jungiklis
sword	Kardas
table	lentelë
tablespoon	ðaukðtas
tackle	spræsti
tactic	taktika
tag	paþymëti
tail	uodega
take	imtis
tale	pasaka
talent	talentas
talented	talentingas
talk	kalbëti
tall	aukðtas
tank	bakas
tap	bakstelëkite
tape	juosta
target	tiksas
task	uþduotis
taste	skonis
tax	mokestis
taxpayer	mokesèiø mokëtojas
tea	arbata
teach	mokyti
teacher	mokytojas
teaching	mokymas
team	komanda
teammate	komandos draugas
tear	aðara
teaspoon	ðaukðtelis
technical	techninis
technician	technikas
technique	technika
technological	technologinës
technology	technologijos
teen	paauglys
teenage	paauglys
teenager	paauglys
telephone	telefonu
telescope	teleskopas
television	televizija
tell	pasakyti
temperature	temperatûra
temple	ðventykla
temporary	laikinas
ten	deðimt
tend	linkæ
tendency	tendencija
tender	ðvelnus
tennis	tenisas
tension	átampa
tent	palapinæ
term	terminas
terms	sàlygos
terrain	vietovës
terrible	baisi
terribly	baisiai
terrific	nuostabus
territory	teritorija
terror	teroras
terrorism	terorizmu
terrorist	teroristas
test	bandymas
testify	liudyti
testimony	liudijimas
testing	bandymai
text	tekstas
textbook	vadovëlis
texture	tekstûra
than	nei
thank	aèiû
thanks	dëkoju
Thanksgiving	Padëkos
that	kad
the	-
theater	teatras
their	jø
they	jie
them	juos
theme	tema
themselves	patys
then	tada
theological	teologinis
theology	teologija
theoretical	teorinis
theory	teorija
therapist	terapeutas
therapy	terapija
there	ten
there	ten
thereby	taip
therefore	todël
these	ðie
thick	storas
thigh	ðlaunis
thin	plonas
thing	dalykas
think	galvoti
thinking	màstymas
third	treèias
thirty	trisdeðimt
this	tai
thoroughly	kruopðèiai
those	tuos
though	nors
thought	maniau
thousand	tûkstantis
thread	siûlai
threat	grësmá
threaten	grasinti
three	trys
threshold	slenkstis
thrive	klestëti
throat	gerklë
through	per
throw	mesti
thumb	nykðèiu
thus	taip
ticket	bilietas
tide	banga
tie	kaklaraiðtis
tight	ankðtus
tighten	priverþkite
tightly	grieþtai
tile	plytelë
till	iki
timber	mediena
time	laikas
timing	laikas
tiny	maþas
tip	patarimas
tire	padanga
tired	pavargæs
tissue	audinys
title	pavadinimas
type	tipas
typical	bûdinga
typically	paprastai
to	á
tobacco	tabakas
today	ðiandien
toe	pirðtai
together	kartu
toilet	tualetas
toy	þaislas
tolerance	tolerancija
tolerate	toleruoti
toll	rinkliava
tomato	pomidoras
tomorrow	rytoj
tone	tonas
tongue	lieþuvis
tonight	ðá vakarà
too	taip pat
tool	árankis
tooth	dantis
top	virðuje
topic	temà
toss	iðmesti
total	ið viso
totally	visiðkai
touch	paliesti
touchdown	prisilietimas
tough	sunku
tour	kelionë
tourism	turizmas
tourist	turistas
tournament	turnyras
toward	link
towel	rankðluostis
tower	bokðtas
town	Miestas
toxic	toksiðkas
trace	pëdsakai
track	stebëti
track	stebëti
trade	prekyba
tradition	tradicija
traditional	tradicinis
traditionally	tradiciðkai
traffic	eismas
tragedy	tragedija
tragic	tragiðka
trail	takas
trailer	priekaba
train	traukinys
trainer	treneris
training	mokymas
trait	bruoþas
tray	padëklas
transaction	sandoris
transfer	perduoti
transform	transformuoti
transformation	transformacija
transit	tranzitas
transition	perëjimas
translate	versti
translation	vertimas
transmission	perdavimas
transmit	perduoti
transport	transportas
transportation	transportavimas
trap	gaudyklë
trash	ðiukðliadëþë
trauma	trauma
travel	kelionë
traveler	keliautojas
treasure	lobis
treat	gydyti
treaty	sutartis
treatment	gydymas
tree	medis
tremendous	didþiulis
trend	tendencija
trial	teismas
tribal	genties
tribe	gentis
trick	triukas
trigger	sukelti
trim	apkarpyti
trip	kelionë
triumph	triumfas
try	bandyti
troop	kariuomenë
tropical	atogràþø
trouble	problema
troubled	neramus
truck	sunkveþimis
truly	nuoðirdþiai
trunk	bagaþinë
trust	pasitikëjimas
truth	tiesa
T-shirt	Marðkinëliai
tube	vamzdis
tuck	ásiminti
tumor	navikas
tune	sureguliuoti
tunnel	tunelis
turn	pasukti
TV	Televizorius
twelve	dvylika
twentieth	dvideðimt
twenty	dvideðimt
twice	dukart
twin	dvivietis
twist	pasukti
two	du
two-thirds	du treèdaliai
ugly	bjaurus
ultimate	galutinis
ultimately	galiausiai
unable	negali
uncertain	neaiðku
uncertainty	netikrumas
uncle	dëdë
uncomfortable	nepatogus
uncover	atskleisti
under	pagal
under	pagal
undergo	atlikti
undergraduate	bakalaurp
underlying	pagrindas
undermine	pakenkti
understand	suprasti
understanding	supratimas
undertake	imtis
unemployment	nedarbas
unexpected	netikëta
unfair	Nesàþininga
unfold	atsiskleisti
unfortunately	Deja
unhappy	nelaimingas
uniform	uniforma
union	sàjunga
unique	Unikalus
unit	vienetas
unite	suvienyti
United	Jungtinë
unity	vienybë
universal	Universalus
universe	visatos
university	universitete
unknown	neþinoma
unless	nebent
unlike	skirtingai
unlikely	tikëtina
unprecedented	precedento neturintis
until	iki
unusual	neáprasta
up	aukðtyn
update	atnaujinti
upon	ant
upper	virðutinis
upset	liûdnas
upstairs	virðutiniame aukðte
urban	miesto
urge	noras
us	mus
use	naudoti
used	naudojamas
useful	naudinga
user	Vartotojas
usual	áprasta
usually	paprastai
utility	naudingumas
utilize	panaudoti
vacation	atostogos
vaccine	vakcina
vacuum	vakuumas
valid	galioti
validity	galiojimas
valley	slënyje
valuable	vertingas
value	vertë
van	furgonas
vanish	iðnyksta
variable	kintamasis
variation	variacija
variety	ávairovë
various	ávairûs
vary	skiriasi
vast	didþiulis
vegetable	darþoviø
vehicle	transporto priemonë
vendor	pardavëjas
venture	rizikos
verbal	þodinis
verdict	nuosprendis
very	labai
version	versija
versus	prieð
vertical	vertikaliai
vessel	laivas
veteran	veteranas
via	per
victim	auka
victory	pergalë
video	vaizdo áraðas
view	vaizdas
viewer	þiûrovas
village	kaimas
violate	paþeisti
violation	paþeidimas
violence	smurto
violent	smurtinis
virtual	virtualus
virtually	praktiðkai
virtue	dorybë
virus	virusas
visible	matomas
vision	vizija
visit	apsilankykti
visitor	lankytojas
visual	vizualiai
vital	gyvybiðkai svarbu
vitamin	vitaminas
vocal	vokalas
voice	balsas
volume	apimtis
voluntary	savanoriðkas
volunteer	savanoris
vote	balsas
voter	rinkëjas
voting	balsavimas
vulnerable	paþeidþiamas
wage	darbo uþmokestis
wagon	vagonas
waist	juosmens
wait	laukti
way	bûdas
wake	pabusti
walking	vaikðèioti
wall	sienos
wander	klajoti
want	noráti
war	karas
warehouse	sandëlis
warm	ðiltas
warmth	ðiluma
warn	áspëti
warning	áspëjimas
warrior	karys
wash	plauti
waste	atliekos
watch	þiûrëti
watch	þiûrëti
water	vanduo
wave	banga
we	mes
weak	silpnas
weaken	susilpninti
weakness	silpnumas
wealth	turtas
wealthy	pasiturintis
weapon	ginklas
wear	dëvëti
weather	oras
weave	pynimas
web	þiniatinklis
wedding	Vestuvës
week	savaitë
weekend	savaitgalá
weekly	savaitæ
weigh	pasverti
weight	svoris
weird	keista
welcome	Sveiki
welfare	gerovë
well	gerai
well-being	gerovë
well-known	garsus
west	á vakarus
western	Vakarø
wet	ðlapias
whale	banginis
what	kà
whatever	Nesvarbu
wheat	kvieèiai
wheel	ratas
wheelchair	neágaliøjø veþimëlis
when	kada
whenever	kada
where	kur
whereas	kadangi
wherever	bet kur
whether	ar
which	kuris
while	kol
whip	plakti
whisper	ðnabþdesys
white	balta
why	kodël
who	kas
whoever	kas nors
whole	visuma
whom	kam
whose	kuriø
wide	platus
widely	plaèiai
widespread	plaèiai paplitæs
widow	naðlë
wife	þmona
wild	laukiniai
wilderness	dykumoje
wildlife	laukinës gamtos
will	valia
willingness	noras
win	laimëti
wind	vëjas
window	langas
wine	vynas
wing	sparnas
winner	nugalëtojas
winter	þiemà
wipe	nuvalyti
wire	viela
wisdom	iðmintis
wise	protingas
wish	noras
with	su
withdraw	pasitraukti
withdrawal	pasitraukimas
within	viduje
without	be
witness	liudytojas
wolf	vilkas
woman	moteris
wonder	stebëtis
wonderful	nuostabus
wood	mediena
wooden	medinis
word	þodis
work	dirbti
worker	darbuotojas
working	darbo
workout	sportuoti
workplace	darbo vietoje
works	veikia
workshop	dirbtuvës
world	pasaulis
worldwide	visame pasaulyje
worried	neramus
worry	nerimauti
worth	verta
would	bûtø
wound	þaizda
wow	Oho
wrap	suvynioti
wrist	rieðas
write	raðyti
writer	raðytojas
writing	raðymas
written	paraðytas
wrong	neteisinga
zone	zona